2222222222500000000000000000000000000000000000000000000000000000000000000
2222222222500000000000000000000000000000000000000000000000000000000000000
2222222222500000000000000000000000000000000000000000000000000000000000000
2222222222500000000000000000000000000000000000000000000000000000000000000
2222222222500000000000000000000000000000000000000000000000000000000000000
2222222222500000000000000000000000000000000000000000000000000000000000000
2222222222500000000000000000000000000000000000000000000000000000000000000
2222222222500000000000000000000000000000000000000000000000000000000000000
2222222222500000000000000000000000000000000000000000000000000000000000000
2222222222500000000000000000000000000000000000000000000000000000000000000
2222222222500000000000000000000000000000000000000000000000000000000000000
2222222222500000000000000000000000000000000000000000000000000000000000000
2222222222500000000000000000000022222222222200000000000000000000000000000
2222222222411130000000000000000000000000000000000000000000000000000000000
2222222222222241111111130000000000000000000000000000000000000000000000000
2222222222222222222222241111111111111111111111111111111111111111111111111
2222222222222222222222222222222222222222222222222222222222222222222222222
2222222222222222222222222222222222222222222222222222222222222222222222222
2222222222222222222222222222222222222222222222222222222222222222222222222
2222222222222222222222222222222222222222222222222222222222222222222222222